R	1920	1080
NO ./textures/mossy.xpm
SO ./textures/redbrick.xpm
EA ./textures/stone.xpm
WE ./textures/wood.xpm
S ./textures/barrel.xpm



1111111111111111111111111111111111111111111
1000000000000000000000000000000002000002001
10000000000000000000000000000000000020000W1
1111111111111111111111111111111111111111111

F 255,0,0255
C 0,128,128
